0 0 0 0 0 0 0 0 0 0 0 0 0 0 0 0 0 0 0 0 0 0 0 0 0 0 0 0 0 0 0 0 0 0 0 0 0 0 0 0 0 0 0 0 0 0 0 0 0 0 
0 0 0 0 0 0 0 0 0 0 0 0 0 0 0 0 0 0 0 0 0 0 0 0 0 0 0 0 0 0 0 0 0 0 0 0 0 0 0 0 0 0 0 0 0 0 0 0 0 0 
0 0 0 0 0 0 0 0 0 0 0 0 0 0 0 0 0 0 0 0 0 0 0 0 0 0 0 0 0 0 0 0 0 0 0 0 0 0 0 0 0 0 0 0 0 0 0 0 0 0 
0 0 0 0 0 0 0 0 0 0 0 0 0 0 0 0 0 0 0 0 0 0 0 0 0 0 0 0 0 0 0 0 0 0 0 0 0 0 0 0 0 0 0 0 0 0 0 0 0 0 
0 0 0 0 0 0 0 0 0 0 0 0 0 0 0 0 0 0 0 0 0 0 0 0 0 0 0 0 0 0 0 0 0 0 0 0 0 0 0 0 0 0 0 0 0 0 0 0 0 0 
0 0 0 0 0 0 0 0 0 0 0 0 0 0 0 0 0 0 0 0 0 0 0 0 0 0 0 0 0 0 0 0 0 0 0 0 0 0 0 0 0 0 0 0 0 0 0 0 0 0 
0 0 0 0 0 0 0 0 0 0 0 0 0 0 0 0 0 0 0 0 0 0 0 0 0 0 0 0 0 0 0 0 0 0 0 0 0 0 0 0 0 0 0 0 0 0 0 0 0 0 
0 0 0 0 0 0 0 0 0 0 0 0 0 0 0 0 0 0 0 0 0 0 0 0 0 0 0 0 0 0 0 0 0 0 0 0 0 0 0 0 0 0 0 0 0 0 0 0 0 0 
0 0 0 0 0 0 0 0 0 0 0 0 0 0 0 0 0 0 0 0 0 0 0 0 0 0 0 0 0 0 0 0 0 0 0 0 0 0 0 0 0 0 0 0 0 0 0 0 0 0 
0 0 0 0 0 0 0 0 0 0 0 0 0 0 0 0 0 0 0 0 0 0 0 0 0 0 0 0 0 0 0 0 0 0 0 0 0 0 0 0 0 0 0 0 0 0 0 0 0 0 
0 0 0 0 0 0 0 0 0 16 33 35 34 16 18 18 18 18 18 18 18 18 18 18 18 18 18 18 18 18 18 18 18 18 18 18 18 18 18 18 18 0 0 0 0 0 0 0 0 0 
0 0 0 0 0 0 0 0 0 16 34 34 34 16 18 18 19 18 18 18 18 18 18 18 18 18 18 19 19 19 19 19 18 18 18 18 16 16 16 16 19 0 0 0 0 0 0 0 0 0 
0 0 0 0 0 0 0 0 0 16 34 34 34 16 18 18 18 19 18 19 19 19 19 19 19 19 19 19 18 18 18 19 19 18 18 18 16 34 16 16 19 0 0 0 0 0 0 0 0 0 
0 0 0 0 0 0 0 0 0 16 34 34 34 16 3 3 3 3 3 3 3 16 16 16 16 16 16 16 16 16 18 18 19 18 18 16 16 34 34 16 19 0 0 0 0 0 0 0 0 0 
0 0 0 0 0 0 0 0 0 16 16 16 34 34 3 3 3 3 3 3 3 16 16 16 16 16 16 16 16 16 16 32 32 32 32 32 32 34 34 16 19 0 0 0 0 0 0 0 0 0 
0 0 0 0 0 0 0 0 0 18 18 18 18 18 18 18 18 16 16 16 3 16 16 20 21 21 22 16 16 16 16 16 16 16 3 3 3 3 3 32 19 0 0 0 0 0 0 0 0 0 
0 0 0 0 0 0 0 0 0 18 19 19 19 19 19 19 19 18 18 16 3 3 16 23 18 18 24 16 16 3 3 3 3 3 3 16 32 32 3 32 19 0 0 0 0 0 0 0 0 0 
0 0 0 0 0 0 0 0 0 18 19 18 18 18 18 18 18 18 18 16 16 3 3 23 18 18 24 16 16 3 16 16 16 34 34 16 16 32 3 32 18 0 0 0 0 0 0 0 0 0 
0 0 0 0 0 0 0 0 0 18 19 19 18 18 18 18 18 18 18 16 16 3 3 23 18 18 24 16 16 3 34 34 34 34 18 18 16 32 3 32 32 0 0 0 0 0 0 0 0 0 
0 0 0 0 0 0 0 0 0 18 18 19 19 18 18 16 16 16 16 16 16 3 3 25 26 26 27 3 3 3 16 16 16 34 19 19 16 32 3 3 32 0 0 0 0 0 0 0 0 0 
0 0 0 0 0 0 0 0 0 18 18 18 19 19 19 18 18 16 16 16 16 16 3 3 3 3 3 3 16 3 3 3 34 34 34 34 16 32 32 3 32 0 0 0 0 0 0 0 0 0 
0 0 0 0 0 0 0 0 0 32 32 32 32 32 32 32 19 18 18 18 18 18 18 16 18 16 16 16 16 16 16 3 3 32 32 32 32 32 3 3 32 0 0 0 0 0 0 0 0 0 
0 0 0 0 0 0 0 0 0 32 34 34 34 34 34 32 19 19 19 19 18 19 19 16 19 19 18 18 18 16 16 16 3 3 3 32 32 32 3 32 32 0 0 0 0 0 0 0 0 0 
0 0 0 0 0 0 0 0 0 32 34 34 34 34 34 32 18 18 18 19 19 18 18 16 18 18 19 18 18 18 18 18 32 32 3 16 3 3 3 32 18 0 0 0 0 0 0 0 0 0 
0 0 0 0 0 0 0 0 0 32 34 34 34 34 34 34 32 32 32 32 32 32 32 16 32 32 32 32 32 32 32 32 32 32 34 16 16 16 16 32 18 0 0 0 0 0 0 0 0 0 
0 0 0 0 0 0 0 0 0 32 32 32 16 16 16 34 3 3 3 3 3 3 3 3 3 3 3 3 3 3 3 3 3 34 34 34 34 34 16 32 18 0 0 0 0 0 0 0 0 0 
0 0 0 0 0 0 0 0 0 18 18 18 16 16 16 34 32 32 32 32 32 32 32 32 3 32 32 32 32 32 32 32 32 32 35 33 35 32 32 32 18 0 0 0 0 0 0 0 0 0 
0 0 0 0 0 0 0 0 0 18 18 18 16 16 16 16 18 18 18 18 18 18 18 32 3 32 18 18 18 18 18 18 18 32 32 32 32 32 18 18 18 0 0 0 0 0 0 0 0 0 
0 0 0 0 0 0 0 0 0 0 0 0 0 0 0 0 0 0 0 0 0 0 0 0 0 0 0 0 0 0 0 0 0 0 0 0 0 0 0 0 0 0 0 0 0 0 0 0 0 0 
0 0 0 0 0 0 0 0 0 0 0 0 0 0 0 0 0 0 0 0 0 0 0 0 0 0 0 0 0 0 0 0 0 0 0 0 0 0 0 0 0 0 0 0 0 0 0 0 0 0 
0 0 0 0 0 0 0 0 0 0 0 0 0 0 0 0 0 0 0 0 0 0 0 0 0 0 0 0 0 0 0 0 0 0 0 0 0 0 0 0 0 0 0 0 0 0 0 0 0 0 
0 0 0 0 0 0 0 0 0 0 0 0 0 0 0 0 0 0 0 0 0 0 0 0 0 0 0 0 0 0 0 0 0 0 0 0 0 0 0 0 0 0 0 0 0 0 0 0 0 0 
0 0 0 0 0 0 0 0 0 0 0 0 0 0 0 0 0 0 0 0 0 0 0 0 0 0 0 0 0 0 0 0 0 0 0 0 0 0 0 0 0 0 0 0 0 0 0 0 0 0 
0 0 0 0 0 0 0 0 0 0 0 0 0 0 0 0 0 0 0 0 0 0 0 0 0 0 0 0 0 0 0 0 0 0 0 0 0 0 0 0 0 0 0 0 0 0 0 0 0 0 
0 0 0 0 0 0 0 0 0 0 0 0 0 0 0 0 0 0 0 0 0 0 0 0 0 0 0 0 0 0 0 0 0 0 0 0 0 0 0 0 0 0 0 0 0 0 0 0 0 0 
0 0 0 0 0 0 0 0 0 0 0 0 0 0 0 0 0 0 0 0 0 0 0 0 0 0 0 0 0 0 0 0 0 0 0 0 0 0 0 0 0 0 0 0 0 0 0 0 0 0 
0 0 0 0 0 0 0 0 0 0 0 0 0 0 0 0 0 0 0 0 0 0 0 0 0 0 0 0 0 0 0 0 0 0 0 0 0 0 0 0 0 0 0 0 0 0 0 0 0 0 
0 0 0 0 0 0 0 0 0 0 0 0 0 0 0 0 0 0 0 0 0 0 0 0 0 0 0 0 0 0 0 0 0 0 0 0 0 0 0 0 0 0 0 0 0 0 0 0 0 0 
0 0 0 0 0 0 0 0 0 0 0 0 0 0 0 0 0 0 0 0 0 0 0 0 0 0 0 0 0 0 0 0 0 0 0 0 0 0 0 0 0 0 0 0 0 0 0 0 0 0 
0 0 0 0 0 0 0 0 0 0 0 0 0 0 0 0 0 0 0 0 0 0 0 0 0 0 0 0 0 0 0 0 0 0 0 0 0 0 0 0 0 0 0 0 0 0 0 0 0 0 
0 0 0 0 0 0 0 0 0 0 0 0 0 0 0 0 0 0 0 0 0 0 0 0 0 0 0 0 0 0 0 0 0 0 0 0 0 0 0 0 0 0 0 0 0 0 0 0 0 0 
0 0 0 0 0 0 0 0 0 0 0 0 0 0 0 0 0 0 0 0 0 0 0 0 0 0 0 0 0 0 0 0 0 0 0 0 0 0 0 0 0 0 0 0 0 0 0 0 0 0 
0 0 0 0 0 0 0 0 0 0 0 0 0 0 0 0 0 0 0 0 0 0 0 0 0 0 0 0 0 0 0 0 0 0 0 0 0 0 0 0 0 0 0 0 0 0 0 0 0 0 
0 0 0 0 0 0 0 0 0 0 0 0 0 0 0 0 0 0 0 0 0 0 0 0 0 0 0 0 0 0 0 0 0 0 0 0 0 0 0 0 0 0 0 0 0 0 0 0 0 0 
0 0 0 0 0 0 0 0 0 0 0 0 0 0 0 0 0 0 0 0 0 0 0 0 0 0 0 0 0 0 0 0 0 0 0 0 0 0 0 0 0 0 0 0 0 0 0 0 0 0 
0 0 0 0 0 0 0 0 0 0 0 0 0 0 0 0 0 0 0 0 0 0 0 0 0 0 0 0 0 0 0 0 0 0 0 0 0 0 0 0 0 0 0 0 0 0 0 0 0 0 
0 0 0 0 0 0 0 0 0 0 0 0 0 0 0 0 0 0 0 0 0 0 0 0 0 0 0 0 0 0 0 0 0 0 0 0 0 0 0 0 0 0 0 0 0 0 0 0 0 0 
0 0 0 0 0 0 0 0 0 0 0 0 0 0 0 0 0 0 0 0 0 0 0 0 0 0 0 0 0 0 0 0 0 0 0 0 0 0 0 0 0 0 0 0 0 0 0 0 0 0 
0 0 0 0 0 0 0 0 0 0 0 0 0 0 0 0 0 0 0 0 0 0 0 0 0 0 0 0 0 0 0 0 0 0 0 0 0 0 0 0 0 0 0 0 0 0 0 0 0 0 
0 0 0 0 0 0 0 0 0 0 0 0 0 0 0 0 0 0 0 0 0 0 0 0 0 0 0 0 0 0 0 0 0 0 0 0 0 0 0 0 0 0 0 0 0 0 0 0 0 0 
