0 0 0 0 0 0 0 0 0 0 0 0 0 0 0 0 0 0 0 0 0 0 0 0 0 0 0 0 0 0 0 0 0 0 0 0 0 0 0 0 0 0 0 0 0 0 0 0 0 0 
0 0 0 0 0 0 0 0 0 0 0 0 0 0 0 0 0 0 0 0 0 0 0 0 0 0 0 0 0 0 0 0 0 0 0 0 0 0 0 0 0 0 0 0 0 0 0 0 0 0 
0 0 0 0 0 0 0 0 0 0 0 0 0 0 0 0 0 0 0 0 0 0 0 0 0 0 0 0 0 0 0 0 0 0 0 0 0 0 0 0 0 0 0 0 0 0 0 0 0 0 
0 0 0 0 0 0 0 0 0 0 0 0 0 0 0 0 0 0 0 0 0 0 0 0 0 0 0 0 0 0 0 0 0 0 0 0 0 0 0 0 0 0 0 0 0 0 0 0 0 0 
0 0 0 0 0 0 0 0 0 0 0 0 0 0 0 0 0 0 0 0 0 0 0 0 0 0 0 0 0 0 0 0 0 0 0 0 0 0 0 0 0 0 0 0 0 0 0 0 0 0 
0 0 0 0 0 0 0 0 0 0 0 0 0 0 0 0 0 0 0 0 0 0 0 0 0 0 0 0 0 0 0 0 0 0 0 0 0 0 0 0 0 0 0 0 0 0 0 0 0 0 
0 0 0 0 0 0 0 0 0 0 0 0 0 0 0 0 0 0 0 0 0 0 0 0 0 0 0 0 0 0 0 0 0 0 0 0 0 0 0 0 0 0 0 0 0 0 0 0 0 0 
0 0 0 0 0 0 0 0 0 0 0 0 0 0 0 0 0 0 0 0 0 0 0 0 0 0 0 0 0 0 0 0 0 0 0 0 0 0 0 0 0 0 0 0 0 0 0 0 0 0 
0 0 0 0 0 0 0 0 0 0 0 0 0 0 0 0 0 0 0 0 0 0 0 0 0 0 0 0 0 0 0 0 0 0 0 0 0 0 0 0 0 0 0 0 0 0 0 0 0 0 
0 0 0 0 0 0 0 0 0 0 0 0 0 0 0 0 0 0 0 0 0 0 0 0 0 0 0 0 0 0 0 0 0 0 0 0 0 0 0 0 0 0 0 0 0 0 0 0 0 0 
0 0 0 0 0 0 0 0 0 33 32 18 18 18 18 18 18 18 18 18 18 18 18 18 18 18 18 18 18 18 32 32 32 3 3 3 3 3 3 3 16 0 0 0 0 0 0 0 0 0 
0 0 0 0 0 0 0 0 0 34 32 18 18 18 18 18 18 19 19 18 18 19 19 32 32 32 32 32 32 32 32 3 3 3 16 32 16 16 16 3 16 0 0 0 0 0 0 0 0 0 
0 0 0 0 0 0 0 0 0 34 32 32 18 18 18 18 19 18 18 19 19 19 18 32 4 5 6 20 21 22 3 3 16 16 32 32 16 3 3 3 16 0 0 0 0 0 0 0 0 0 
0 0 0 0 0 0 0 0 0 34 3 32 32 18 18 18 19 19 19 19 18 18 19 32 9 10 11 25 26 27 3 16 32 32 3 3 3 3 3 3 16 0 0 0 0 0 0 0 0 0 
0 0 0 0 0 0 0 0 0 16 3 16 32 32 18 18 18 18 18 18 18 18 19 32 32 32 3 3 3 3 3 32 16 16 3 20 21 21 22 3 16 0 0 0 0 0 0 0 0 0 
0 0 0 0 0 0 0 0 0 16 3 3 16 32 32 32 18 18 18 18 18 18 18 32 3 3 3 16 16 16 16 16 16 16 3 25 26 26 27 3 16 0 0 0 0 0 0 0 0 0 
0 0 0 0 0 0 0 0 0 16 16 3 16 16 17 32 32 18 18 18 18 18 18 32 3 16 16 16 32 32 32 32 16 32 3 17 17 17 16 3 16 0 0 0 0 0 0 0 0 0 
0 0 0 0 0 0 0 0 0 16 16 3 16 16 17 17 32 32 32 32 32 32 32 32 3 32 32 32 32 16 16 16 16 32 3 17 17 17 16 3 16 0 0 0 0 0 0 0 0 0 
0 0 0 0 0 0 0 0 0 16 3 3 3 3 3 3 30 31 18 16 16 16 16 16 3 3 3 3 37 18 18 18 18 32 16 16 16 16 16 3 16 0 0 0 0 0 0 0 0 0 
0 0 0 0 0 0 0 0 0 16 3 16 16 16 16 3 16 16 3 3 3 3 3 3 3 16 16 3 3 16 3 3 3 16 3 16 16 3 3 3 16 0 0 0 0 0 0 0 0 0 
0 0 0 0 0 0 0 0 0 16 3 16 16 16 16 3 3 3 3 16 16 3 16 16 16 16 16 16 3 3 3 16 3 3 3 3 16 3 3 16 16 0 0 0 0 0 0 0 0 0 
0 0 0 0 0 0 0 0 0 16 3 3 3 3 3 3 18 18 18 16 16 3 3 16 16 3 3 3 37 18 18 18 18 32 3 3 3 3 3 16 16 0 0 0 0 0 0 0 0 0 
0 0 0 0 0 0 0 0 0 16 2 2 2 16 17 17 32 32 32 32 32 32 3 16 16 3 32 32 32 16 16 16 16 16 16 3 3 16 32 32 32 0 0 0 0 0 0 0 0 0 
0 0 0 0 0 0 0 0 0 16 20 21 22 16 17 32 32 18 18 18 18 32 3 3 3 3 18 18 32 32 32 32 32 32 16 16 3 3 3 3 16 0 0 0 0 0 0 0 0 0 
0 0 0 0 0 0 0 0 0 16 25 26 27 16 32 32 18 19 18 18 18 32 32 32 32 32 32 32 32 19 19 18 18 32 32 32 32 32 32 3 16 0 0 0 0 0 0 0 0 0 
0 0 0 0 0 0 0 0 0 16 16 16 16 16 32 18 18 19 19 19 19 19 19 19 19 19 19 19 18 18 18 19 19 18 18 18 32 32 34 34 34 0 0 0 0 0 0 0 0 0 
0 0 0 0 0 0 0 0 0 16 16 16 16 32 32 18 18 19 19 19 19 19 18 18 18 18 18 19 19 19 18 19 19 18 18 18 18 32 34 35 34 0 0 0 0 0 0 0 0 0 
0 0 0 0 0 0 0 0 0 16 16 16 16 32 18 18 18 18 18 18 18 18 18 18 18 18 18 18 18 18 19 19 18 18 18 18 18 18 32 32 33 0 0 0 0 0 0 0 0 0 
0 0 0 0 0 0 0 0 0 0 0 0 0 0 0 0 0 0 0 0 0 0 0 0 0 0 0 0 0 0 0 0 0 0 0 0 0 0 0 0 0 0 0 0 0 0 0 0 0 0 
0 0 0 0 0 0 0 0 0 0 0 0 0 0 0 0 0 0 0 0 0 0 0 0 0 0 0 0 0 0 0 0 0 0 0 0 0 0 0 0 0 0 0 0 0 0 0 0 0 0 
0 0 0 0 0 0 0 0 0 0 0 0 0 0 0 0 0 0 0 0 0 0 0 0 0 0 0 0 0 0 0 0 0 0 0 0 0 0 0 0 0 0 0 0 0 0 0 0 0 0 
0 0 0 0 0 0 0 0 0 0 0 0 0 0 0 0 0 0 0 0 0 0 0 0 0 0 0 0 0 0 0 0 0 0 0 0 0 0 0 0 0 0 0 0 0 0 0 0 0 0 
0 0 0 0 0 0 0 0 0 0 0 0 0 0 0 0 0 0 0 0 0 0 0 0 0 0 0 0 0 0 0 0 0 0 0 0 0 0 0 0 0 0 0 0 0 0 0 0 0 0 
0 0 0 0 0 0 0 0 0 0 0 0 0 0 0 0 0 0 0 0 0 0 0 0 0 0 0 0 0 0 0 0 0 0 0 0 0 0 0 0 0 0 0 0 0 0 0 0 0 0 
0 0 0 0 0 0 0 0 0 0 0 0 0 0 0 0 0 0 0 0 0 0 0 0 0 0 0 0 0 0 0 0 0 0 0 0 0 0 0 0 0 0 0 0 0 0 0 0 0 0 
0 0 0 0 0 0 0 0 0 0 0 0 0 0 0 0 0 0 0 0 0 0 0 0 0 0 0 0 0 0 0 0 0 0 0 0 0 0 0 0 0 0 0 0 0 0 0 0 0 0 
0 0 0 0 0 0 0 0 0 0 0 0 0 0 0 0 0 0 0 0 0 0 0 0 0 0 0 0 0 0 0 0 0 0 0 0 0 0 0 0 0 0 0 0 0 0 0 0 0 0 
0 0 0 0 0 0 0 0 0 0 0 0 0 0 0 0 0 0 0 0 0 0 0 0 0 0 0 0 0 0 0 0 0 0 0 0 0 0 0 0 0 0 0 0 0 0 0 0 0 0 
0 0 0 0 0 0 0 0 0 0 0 0 0 0 0 0 0 0 0 0 0 0 0 0 0 0 0 0 0 0 0 0 0 0 0 0 0 0 0 0 0 0 0 0 0 0 0 0 0 0 
0 0 0 0 0 0 0 0 0 0 0 0 0 0 0 0 0 0 0 0 0 0 0 0 0 0 0 0 0 0 0 0 0 0 0 0 0 0 0 0 0 0 0 0 0 0 0 0 0 0 
0 0 0 0 0 0 0 0 0 0 0 0 0 0 0 0 0 0 0 0 0 0 0 0 0 0 0 0 0 0 0 0 0 0 0 0 0 0 0 0 0 0 0 0 0 0 0 0 0 0 
0 0 0 0 0 0 0 0 0 0 0 0 0 0 0 0 0 0 0 0 0 0 0 0 0 0 0 0 0 0 0 0 0 0 0 0 0 0 0 0 0 0 0 0 0 0 0 0 0 0 
0 0 0 0 0 0 0 0 0 0 0 0 0 0 0 0 0 0 0 0 0 0 0 0 0 0 0 0 0 0 0 0 0 0 0 0 0 0 0 0 0 0 0 0 0 0 0 0 0 0 
0 0 0 0 0 0 0 0 0 0 0 0 0 0 0 0 0 0 0 0 0 0 0 0 0 0 0 0 0 0 0 0 0 0 0 0 0 0 0 0 0 0 0 0 0 0 0 0 0 0 
0 0 0 0 0 0 0 0 0 0 0 0 0 0 0 0 0 0 0 0 0 0 0 0 0 0 0 0 0 0 0 0 0 0 0 0 0 0 0 0 0 0 0 0 0 0 0 0 0 0 
0 0 0 0 0 0 0 0 0 0 0 0 0 0 0 0 0 0 0 0 0 0 0 0 0 0 0 0 0 0 0 0 0 0 0 0 0 0 0 0 0 0 0 0 0 0 0 0 0 0 
0 0 0 0 0 0 0 0 0 0 0 0 0 0 0 0 0 0 0 0 0 0 0 0 0 0 0 0 0 0 0 0 0 0 0 0 0 0 0 0 0 0 0 0 0 0 0 0 0 0 
0 0 0 0 0 0 0 0 0 0 0 0 0 0 0 0 0 0 0 0 0 0 0 0 0 0 0 0 0 0 0 0 0 0 0 0 0 0 0 0 0 0 0 0 0 0 0 0 0 0 
0 0 0 0 0 0 0 0 0 0 0 0 0 0 0 0 0 0 0 0 0 0 0 0 0 0 0 0 0 0 0 0 0 0 0 0 0 0 0 0 0 0 0 0 0 0 0 0 0 0 
0 0 0 0 0 0 0 0 0 0 0 0 0 0 0 0 0 0 0 0 0 0 0 0 0 0 0 0 0 0 0 0 0 0 0 0 0 0 0 0 0 0 0 0 0 0 0 0 0 0 
