0 0 0 0 0 0 0 0 0 0 0 0 0 0 0 0 0 0 0 0 0 0 0 0 0 0 0 0 0 0 0 0 0 0 0 0 0 0 0 0 0 0 0 0 0 0 0 0 0 0 
0 0 0 0 0 0 0 0 0 0 0 0 0 0 0 0 0 0 0 0 0 0 0 0 0 0 0 0 0 0 0 0 0 0 0 0 0 0 0 0 0 0 0 0 0 0 0 0 0 0 
0 0 0 0 0 0 0 0 0 0 0 0 0 0 0 0 0 0 0 0 0 0 0 0 0 0 0 0 0 0 0 0 0 0 0 0 0 0 0 0 0 0 0 0 0 0 0 0 0 0 
0 0 0 0 0 0 0 0 0 0 0 0 0 0 0 0 0 0 0 0 0 0 0 0 0 0 0 0 0 0 0 0 0 0 0 0 0 0 0 0 0 0 0 0 0 0 0 0 0 0 
0 0 0 0 0 0 0 0 0 0 0 0 0 0 0 0 0 0 0 0 0 0 0 0 0 0 0 0 0 0 0 0 0 0 0 0 0 0 0 0 0 0 0 0 0 0 0 0 0 0 
0 0 0 0 0 0 0 0 0 0 0 0 0 0 0 0 0 0 0 0 0 0 0 0 0 0 0 0 0 0 0 0 0 0 0 0 0 0 0 0 0 0 0 0 0 0 0 0 0 0 
0 0 0 0 0 0 0 0 0 0 0 0 0 0 0 0 0 0 0 0 0 0 0 0 0 0 0 0 0 0 0 0 0 0 0 0 0 0 0 0 0 0 0 0 0 0 0 0 0 0 
0 0 0 0 0 0 0 0 0 0 175 175 175 175 175 175 175 175 175 175 175 175 175 175 175 175 175 175 175 175 175 175 175 175 175 175 175 175 175 175 0 0 0 0 0 0 0 0 0 0 
0 0 0 0 0 0 0 0 0 0 175 175 175 175 175 175 175 175 175 175 175 175 175 175 175 175 175 175 175 175 175 175 175 175 175 175 175 175 175 175 0 0 0 0 0 0 0 0 0 0 
0 0 0 0 0 0 0 0 0 0 175 175 175 175 175 175 175 175 175 175 175 175 175 175 175 175 175 175 175 175 175 175 175 175 175 175 175 175 175 175 0 0 0 0 0 0 0 0 0 0 
0 0 0 0 0 0 0 0 0 0 175 175 175 175 175 175 175 175 175 175 175 175 175 224 224 224 224 224 224 224 224 224 224 224 224 224 224 175 175 175 0 0 0 0 0 0 0 0 0 0 
0 0 0 0 0 0 0 0 0 0 175 175 175 175 175 175 175 175 175 175 175 175 175 224 224 224 224 224 224 224 224 224 224 224 224 224 224 175 175 175 0 0 0 0 0 0 0 0 0 0 
0 0 0 0 0 0 0 0 0 0 175 175 175 175 175 175 175 175 175 175 175 175 175 224 224 224 224 224 224 224 224 224 224 224 224 224 224 175 175 175 0 0 0 0 0 0 0 0 0 0 
0 0 0 0 0 0 0 0 0 0 175 175 175 175 175 175 175 175 175 175 175 175 175 224 224 224 224 224 224 224 224 224 224 224 224 224 224 175 175 175 0 0 0 0 0 0 0 0 0 0 
0 0 0 0 0 0 0 0 0 0 175 175 175 175 175 175 175 175 175 175 175 175 175 224 224 224 224 224 224 224 224 224 224 224 224 224 224 175 175 175 0 0 0 0 0 0 0 0 0 0 
0 0 0 0 0 0 0 0 0 0 175 175 175 175 175 175 175 175 175 175 175 175 175 224 224 224 224 224 224 224 224 224 224 224 224 224 224 175 175 175 0 0 0 0 0 0 0 0 0 0 
0 0 0 0 0 0 0 0 0 0 175 175 175 175 175 175 175 175 175 175 175 175 175 224 224 224 224 224 224 224 224 224 224 224 224 224 224 175 175 175 0 0 0 0 0 0 0 0 0 0 
0 0 0 0 0 0 0 0 0 0 175 175 175 175 175 175 175 175 175 175 175 175 175 224 224 224 224 224 224 224 224 224 224 224 224 224 224 175 175 175 0 0 0 0 0 0 0 0 0 0 
0 0 0 0 0 0 0 0 0 0 175 175 175 175 175 175 175 175 175 175 175 175 175 224 224 224 224 224 224 224 224 224 224 224 224 224 224 175 175 175 0 0 0 0 0 0 0 0 0 0 
0 0 0 0 0 0 0 0 0 0 175 175 175 175 175 175 175 175 175 175 175 175 175 224 224 224 224 224 224 224 224 224 224 224 224 224 224 175 175 175 0 0 0 0 0 0 0 0 0 0 
0 0 0 0 0 0 0 0 0 0 175 175 175 175 175 175 175 175 175 175 175 175 175 224 224 224 224 224 224 224 224 224 224 224 224 224 224 175 175 175 0 0 0 0 0 0 0 0 0 0 
0 0 0 0 0 0 0 0 0 0 175 175 175 175 175 175 175 175 175 175 175 175 175 224 224 224 224 224 224 224 224 224 224 224 224 224 224 175 175 175 0 0 0 0 0 0 0 0 0 0 
0 0 0 0 0 0 0 0 0 0 175 175 175 175 175 175 175 175 175 175 175 175 175 224 224 224 224 224 224 224 224 224 224 224 224 224 224 175 175 175 0 0 0 0 0 0 0 0 0 0 
0 0 0 0 0 0 0 0 0 0 175 175 175 175 175 175 175 175 175 175 175 175 175 224 224 224 224 224 224 224 224 224 224 224 224 224 224 175 175 175 0 0 0 0 0 0 0 0 0 0 
0 0 0 0 0 0 0 0 0 0 224 224 224 224 224 224 224 224 224 224 224 224 224 224 224 224 224 224 224 224 224 224 224 224 224 224 224 224 224 224 0 0 0 0 0 0 0 0 0 0 
0 0 0 0 0 0 0 0 0 0 183 183 183 183 183 183 183 183 221 224 224 224 224 224 224 224 224 224 224 224 224 224 224 224 224 224 224 224 224 224 0 0 0 0 0 0 0 0 0 0 
0 0 0 0 0 0 0 0 0 0 182 182 182 182 182 182 182 182 222 224 224 224 224 224 224 224 224 224 224 224 224 224 224 224 224 224 224 224 224 224 0 0 0 0 0 0 0 0 0 0 
0 0 0 0 0 0 0 0 0 0 224 224 224 224 224 224 224 224 224 224 224 224 224 224 224 224 224 224 224 224 224 224 224 224 224 224 224 224 224 224 0 0 0 0 0 0 0 0 0 0 
0 0 0 0 0 0 0 0 0 0 175 175 175 175 175 175 175 175 175 175 175 175 175 224 224 224 224 224 224 224 224 224 224 224 224 224 224 175 175 175 0 0 0 0 0 0 0 0 0 0 
0 0 0 0 0 0 0 0 0 0 175 175 175 175 175 175 175 175 175 175 175 175 175 224 224 224 224 224 224 224 224 224 224 224 224 224 224 175 175 175 0 0 0 0 0 0 0 0 0 0 
0 0 0 0 0 0 0 0 0 0 175 175 175 175 175 175 175 175 175 175 175 175 175 224 224 224 224 224 224 224 224 224 224 224 224 224 224 175 175 175 0 0 0 0 0 0 0 0 0 0 
0 0 0 0 0 0 0 0 0 0 175 175 175 175 175 175 175 175 175 175 175 175 175 224 224 224 224 224 224 224 224 224 224 224 224 224 224 175 175 175 0 0 0 0 0 0 0 0 0 0 
0 0 0 0 0 0 0 0 0 0 175 175 175 175 175 175 175 175 175 175 175 175 175 224 224 224 224 224 224 224 224 224 224 224 224 224 224 175 175 175 0 0 0 0 0 0 0 0 0 0 
0 0 0 0 0 0 0 0 0 0 175 175 175 175 175 175 175 175 175 175 175 175 175 224 224 224 224 224 224 224 224 224 224 224 224 224 224 175 175 175 0 0 0 0 0 0 0 0 0 0 
0 0 0 0 0 0 0 0 0 0 175 175 175 175 175 175 175 175 175 175 175 175 175 224 224 224 224 224 224 224 224 224 224 224 224 224 224 175 175 175 0 0 0 0 0 0 0 0 0 0 
0 0 0 0 0 0 0 0 0 0 175 175 175 175 175 175 175 175 175 175 175 175 175 224 224 224 224 224 224 224 224 224 224 224 224 224 224 175 175 175 0 0 0 0 0 0 0 0 0 0 
0 0 0 0 0 0 0 0 0 0 175 175 175 175 175 175 175 175 175 175 175 175 175 224 224 224 224 224 224 224 224 224 224 224 224 224 224 175 175 175 0 0 0 0 0 0 0 0 0 0 
0 0 0 0 0 0 0 0 0 0 175 175 175 175 175 175 175 175 175 175 175 175 175 224 224 224 224 224 224 224 224 224 224 224 224 224 224 175 175 175 0 0 0 0 0 0 0 0 0 0 
0 0 0 0 0 0 0 0 0 0 175 175 175 175 175 175 175 175 175 175 175 175 175 224 224 224 224 224 224 224 224 224 224 224 224 224 224 175 175 175 0 0 0 0 0 0 0 0 0 0 
0 0 0 0 0 0 0 0 0 0 175 175 175 175 175 175 175 175 175 175 175 175 175 224 224 224 224 224 224 224 224 224 224 224 224 224 224 175 175 175 0 0 0 0 0 0 0 0 0 0 
0 0 0 0 0 0 0 0 0 0 175 175 175 175 175 175 175 175 175 175 175 175 175 224 224 224 224 224 224 224 224 224 224 224 224 224 224 175 175 175 0 0 0 0 0 0 0 0 0 0 
0 0 0 0 0 0 0 0 0 0 175 175 175 175 175 175 175 175 175 175 175 175 175 175 175 175 175 175 175 175 175 175 175 175 175 175 175 175 175 175 0 0 0 0 0 0 0 0 0 0 
0 0 0 0 0 0 0 0 0 0 175 175 175 175 175 175 175 175 175 175 175 175 175 175 175 175 175 175 175 175 175 175 175 175 175 175 175 175 175 175 0 0 0 0 0 0 0 0 0 0 
0 0 0 0 0 0 0 0 0 0 175 175 175 175 175 175 175 175 175 175 175 175 175 175 175 175 175 175 175 175 175 175 175 175 175 175 175 175 175 175 0 0 0 0 0 0 0 0 0 0 
0 0 0 0 0 0 0 0 0 0 0 0 0 0 0 0 0 0 0 0 0 0 0 0 0 0 0 0 0 0 0 0 0 0 0 0 0 0 0 0 0 0 0 0 0 0 0 0 0 0 
0 0 0 0 0 0 0 0 0 0 0 0 0 0 0 0 0 0 0 0 0 0 0 0 0 0 0 0 0 0 0 0 0 0 0 0 0 0 0 0 0 0 0 0 0 0 0 0 0 0 
0 0 0 0 0 0 0 0 0 0 0 0 0 0 0 0 0 0 0 0 0 0 0 0 0 0 0 0 0 0 0 0 0 0 0 0 0 0 0 0 0 0 0 0 0 0 0 0 0 0 
0 0 0 0 0 0 0 0 0 0 0 0 0 0 0 0 0 0 0 0 0 0 0 0 0 0 0 0 0 0 0 0 0 0 0 0 0 0 0 0 0 0 0 0 0 0 0 0 0 0 
0 0 0 0 0 0 0 0 0 0 0 0 0 0 0 0 0 0 0 0 0 0 0 0 0 0 0 0 0 0 0 0 0 0 0 0 0 0 0 0 0 0 0 0 0 0 0 0 0 0 
0 0 0 0 0 0 0 0 0 0 0 0 0 0 0 0 0 0 0 0 0 0 0 0 0 0 0 0 0 0 0 0 0 0 0 0 0 0 0 0 0 0 0 0 0 0 0 0 0 0 
